w00 w00 w00 w00 w00 w00 w00 w00 w00 w00 w00 w00 w00 w00 w00 w00 w00 w00 w00 w00 w00 w00 w00
w00 s00 s00 s00 s00 s00 s00 s00 s00 s00 s00 s00 s00 s00 s00 s00 s00 s00 s00 s00 s00 s00 w00
w00 s00 s00 s00 s00 s00 s00 s00 s00 s00 s00 s00 s00 s00 s00 s00 s00 s00 s00 s00 s00 s00 w00
w00 s00 s00 w00 w00 w00 w00 w00 w00 s00 s00 w00 s00 s00 s00 s00 s00 s00 s00 s00 s00 s00 w00
w00 s00 s00 w00 s00 s00 s00 s00 w00 s00 s00 s00 s00 s00 s00 s00 s00 s00 s00 s00 s00 s00 w00
w00 s00 s00 w00 s00 s00 s00 s00 w00 s00 s00 s00 s00 s00 s00 s00 s00 s00 s00 s00 s00 s00 w00
w00 s00 s00 w00 s00 s00 s00 s00 w00 s00 s00 s00 s00 s00 s00 s00 s00 s00 s00 s00 s00 s00 w00
w00 s00 s00 w00 w00 s00 s00 w00 w00 s00 s00 s00 s00 s00 s00 s00 s00 s00 s00 s00 s00 s00 w00
w00 s00 s00 s00 s00 s00 s00 s00 s00 s00 s00 s00 s00 s00 s00 s00 s00 s00 s00 s00 s00 s00 w00
w00 s00 s00 s00 s00 s00 s00 s00 s00 s00 s00 s00 s00 s00 s00 s00 s00 s00 s00 s00 s00 s00 w00
w00 s00 s00 s00 s00 s00 s00 s00 s00 s00 s00 s00 s00 s00 s00 s00 s00 s00 s00 s00 s00 s00 w00
w00 s00 s00 s00 s00 s00 s00 s00 s00 s00 s00 s00 s00 s00 s00 s00 s00 s00 s00 s00 s00 s00 w00
w00 s00 s00 w00 w00 w00 w00 w00 w00 s00 s00 s00 s00 s00 s00 s00 s00 s00 s00 s00 s00 s00 w00
w00 s00 s00 w00 s00 s00 s00 s00 w00 s00 s00 s00 s00 s00 s00 s00 s00 s00 s00 s00 s00 s00 w00
w00 s00 s00 w00 s00 s00 s00 s00 w00 s00 s00 s00 s00 s00 s00 s00 s00 s00 s00 s00 s00 s00 w00
w00 s00 s00 w00 s00 s00 s00 s00 w00 s00 s00 s00 s00 s00 s00 s00 s00 s00 s00 s00 s00 s00 w00
w00 s00 s00 w00 w00 s00 s00 w00 w00 s00 s00 s00 s00 s00 s00 s00 s00 s00 s00 s00 s00 s00 w00
w00 s00 s00 s00 s00 s00 s00 s00 s00 s00 s00 s00 s00 s00 s00 s00 s00 s00 s00 s00 s00 s00 w00
w00 s00 s00 s00 s00 s00 s00 s00 s00 s00 s00 s00 s00 s00 s00 s00 s00 s00 s00 s00 s00 s00 w00
w00 s00 s00 s00 s00 s00 s00 s00 s00 s00 s00 s00 s00 s00 s00 s00 s00 s00 s00 s00 s00 s00 w00
w00 s00 s00 w00 w00 w00 w00 w00 w00 s00 s00 s00 s00 s00 s00 s00 s00 s00 s00 s00 s00 s00 w00
w00 s00 s00 w00 s00 s00 s00 s00 w00 s00 s00 s00 s00 s00 s00 s00 s00 s00 s00 s00 s00 s00 w00
w00 s00 s00 w00 s00 s00 s00 s00 w00 s00 s00 s00 s00 s00 s00 s00 s00 s00 s00 s00 s00 s00 w00
w00 s00 s00 w00 s00 s00 s00 s00 w00 s00 s00 s00 s00 s00 s00 s00 s00 s00 s00 s00 s00 s00 w00
w00 s00 s00 w00 w00 s00 s00 w00 w00 s00 s00 s00 s00 s00 s00 s00 s00 s00 s00 s00 s00 s00 w00
w00 s00 s00 s00 s00 s00 s00 s00 s00 s00 s00 s00 s00 s00 s00 s00 s00 s00 s00 s00 s00 s00 w00
w00 s00 s00 s00 s00 s00 s00 s00 s00 s00 s00 s00 s00 s00 s00 s00 s00 s00 s00 s00 s00 s00 w00
w00 s00 s00 s00 s00 s00 s00 s00 s00 s00 s00 s00 s00 s00 s00 s00 s00 s00 s00 s00 s00 s00 w00
w00 s00 s00 w00 w00 w00 w00 w00 w00 s00 s00 s00 s00 s00 s00 s00 s00 s00 s00 s00 s00 s00 w00
w00 s00 s00 w00 s00 s00 s00 s00 w00 s00 s00 s00 s00 s00 s00 s00 s00 s00 s00 s00 s00 s00 w00
w00 s00 s00 w00 s00 s00 s00 s00 w00 s00 s00 s00 s00 s00 s00 s00 s00 s00 s00 s00 s00 s00 w00
w00 s00 s00 w00 s00 s00 s00 s00 w00 s00 s00 s00 s00 s00 s00 s00 s00 s00 s00 s00 s00 s00 w00
w00 s00 s00 w00 w00 s00 s00 w00 w00 s00 s00 s00 s00 s00 s00 s00 s00 s00 s00 s00 s00 s00 w00
w00 s00 s00 s00 s00 s00 s00 s00 s00 s00 s00 s00 s00 s00 s00 s00 s00 s00 s00 s00 s00 s00 w00
w00 s00 s00 s00 s00 s00 s00 s00 s00 s00 s00 s00 s00 s00 s00 s00 s00 s00 s00 s00 s00 s00 w00
w00 s00 s00 s00 s00 s00 s00 s00 s00 s00 s00 s00 s00 s00 s00 s00 s00 s00 s00 s00 s00 s00 w00
w00 s00 s00 w00 w00 w00 w00 w00 w00 s00 s00 s00 s00 s00 s00 s00 s00 s00 s00 s00 s00 s00 w00
w00 s00 s00 w00 s00 s00 s00 s00 w00 s00 s00 s00 s00 s00 s00 s00 s00 s00 s00 s00 s00 s00 w00
w00 s00 s00 w00 s00 s00 s00 s00 w00 s00 s00 s00 e00 s00 s00 s00 s00 s00 s00 s00 s00 s00 w00
w00 s00 s00 w00 s00 s00 s00 s00 w00 s00 s00 s00 s00 s00 s00 s00 s00 s00 s00 s00 s00 s00 w00
w00 s00 s00 w00 w00 s00 s00 w00 w00 s00 s00 s00 s00 s00 s00 s00 s00 s00 s00 s00 s00 s00 w00
w00 s00 s00 s00 s00 s00 s00 s00 s00 s00 s00 s00 s00 s00 s00 s00 s00 s00 s00 s00 s00 s00 w00
w00 s00 s00 s00 s00 p00 s00 s00 s00 s00 s00 s00 s00 s00 s00 s00 s00 s00 s00 s00 s00 s00 w00
w00 w00 w00 w00 w00 w00 w00 w00 w00 w00 w00 w00 w00 w00 w00 w00 w00 w00 w00 w00 w00 w00 w00